SO ./textures/south.xpm
NO ./textures/north.xpm
EA ./textures/east.xpm
WE ./textures/west.xpm

DOOR ./bonus_assets/door.xpm

F 256, 126, 53
C 94, 86, 46


1111111111111111111
100001001001000001
100W00000000000001
1001000001000001001
1010010011111001111
1001111000001001001
100D000000000001001
1001111111111011001
111000000000001011
1000000001000000001
1111111111111111111




