NO ./textures/north.xpm
SO ./textures/south.xpm
WE ./textures/west.xpm
EA ./textures/east.xpm

F 140, 126, 53
C 94, 86, 46


111111111
1000000001
1000011111
1000E1
1000001111
1000000001
111111111



