NO ./textures/north.xpm
SO ./textures/south.xpm
WE ./textures/west.xpm
EA ./textures/east.xpm

DOOR ./bonus_assets/door.xpm

F 140, 126, 53
C 94, 86, 46


111111111
100000001
100000001
1000N0001
1001D1001
100100101
111111111




