NO ./textures/north.xpm
SO ./textures/south.xpm
WE ./textures/west.xpm
EA ./textures/east.xpm
DOOR ./bonus_assets/door.xpm


F 140, 126, 53
C 94, 86, 46



111111111111111111111111111111111111111111111111111111111
100000001000000000000111111100000000001000000000000000001
1000E000100000000000000000000000000000D000000000000000111
10000000D000000000000000000000000000001000000000000001111
111111111111111100000000000000000000001000000000111111111
10000000000000010000000111111111111D1111D1100000000000001
100000000000000111D11110000000000000000000100000000001111
100000000000000000000010000010000001000000100000000001011
1111111111111111000000100000000100000000001111111111111111111111111111111111111
                10000010001000000000010000D000000000000001000000000000000000001
                10000010000000000000000000100000000000000D000000000000000000001
                1000001111111111111111111111111111111111110000000000000111D1111
                100000100000000000000000000000000000000001000000000000010000001
                111D11100000000000000000000000000000000111111111111111110000001
                100000010000000000000000000000000000000100000000000000000000001
                10000001000000111111D111100000000000000100000000000000000000001
                100000010000001000000000100000000000000100000000000000111111111
        11111111000000010000001000000000100000000000000100000000000001
        10000000000000010000001000000000100000000000000100000000000001
        10000000000000010000001000000000D00000000000000100000000000001
        11D1111111111111000000100000000011111111111D11111111111D111111
        1000000000000000000000D000000000100000000000000000000000000001
        10000000000000000000001000000000100000000000000000000000000001
        1111111111111111111111111111111111111111111111111111111111111