NO ./textures/north.xpm
SO ./textures/south.xpm
WE ./textures/west.xpm
EA ./textures/east.xpm

DOOR ./bonus_assets/door.xpm

C 94, 86, 46
F 140, 126, 53


11111111111111 111111111
100000000100001000000001
1000000000000000000001111111111111111111111111111111111111111111
10000000000000000000000000000000000000000000000000000000000000001
1000000000000000000000011111111111111111111111111111111111111111111
1111D1111111111111D11111
100000001  10000000000001 111111111
100000001110000S00000001 1110000111
1000000000000DDDDDDDD001 1111111111
100000000000100000000001
100000000001 10000000001
100000000000100000000001
100000000000000000010001
1000000000000000001 1001
1111111111111111111 1111




