NO ./textures/north.xpm
SO ./textures/south.xpm
WE ./textures/west.xpm
EA ./textures/east.xpm

DOOR ./bonus_assets/door.xpm

F 140, 126, 53
C 94, 86, 46


1111111111111111111
1001001001001000001
100DW00000000000001
1001000001000001001
1010010011111D1111
1001111000001001001
100D000000000001001
1001111111111D11001
111000000000001011
1000000001000000001
1111111111111111111




