NO ./textures/north.xpm
SO ./textures/west.xpm
WE ./textures/west.xpm
EA ./textures/east.xpm


F 0,100,0
C 0,0,120


111111111
1000000S1
1000000001
1111111111




