NO ./textures/north.xpm
SO ./textures/west.xpm
WE ./textures/west.xpm
EA ./textures/east.xpm


F 100,100,100
C 50,50,100


1111111111
1000000001
1000100N11
1000000001
1111111111




