NO ./textures/north.xpm
SO ./textures/west.xpm
WE ./textures/west.xpm
EA ./textures/east.xpm


F 0,100,0
C 0,0,120

1111111111
1111111111
1000000N111
10000000011
11111111111




